SNV = single nucleotide variant
ITH = intratumour heterogeneity
HR = homologous recombination
HRD = homologous recombination deficiency
DDR = deficient DNA repair
MMR = mismatch repair
SSE = sum of squared errors
NNLS = non-negative least squares
QP = quadratic programming
NGS = Next-generation sequencing
HMC = Hamiltonial Monte Carlo
EM = expectation maximization
CNV = copy number variant
TCGA = The Cancer Genome Atlas
GDC = Genomic Data Commons
MAF = mutation annotation format
OCT = optimal cutting temperature
FFPE = formalin-fixed and paraffin embedded
SV = structural variant
NMF = non-negative matrix factorization
SA = simulated annealing
VAF = variant allele fraction
ADVI = automatic differentiation variational inference
WGS = whole genome sequencing
COSMIC = Catalogue of Somatic Mutations in Cancer
PARP = poly (ADP-ribose) polymerase
WES = whole exome sequencing
WAIC = Watanabe-Akaike information criterion
MCMC = Markov-chain Monte Carlo
POG = Personalized Oncogenomics Project
BER = base excision repair
HMM = hidden Markov model
LOH = loss of heterozygosity
BTP = binary temporal partitioning
RPKM = reads per kilobase of transcript per million mapped reads
UV = ultraviolet
PNET = pancreatic neuroendocrine tumour
MSI = microsatellite instability
